Visual C++案例教程	程序设计
设计可扩展的.NET应用程序	互连网络-程序设计
Visual Basic .NET面向对象编程	BASIC语言-程序设计
基于B/S结构的软件开发技术	互联网络-软件工具-程序设计
HTML5与WebGL编程	网页制作工具-程序设计-超文本标记语言,HTML 5
C/C++程序员面试宝典	C语言-程序设计
程序调试思想与实践	程序设计
iOS程序员面试笔试宝典	移动终端-应用程序-程序设计
Qt高级编程	软件工具-程序设计
Java 7程序设计	JAVA语言-程序设计 
嵌入式系统基础实验	程序设计-高等学校-教材
ML程序设计教程	程序语言-程序设计-教材
SVG开发实践	计算机网络-可扩充语言
网络组建与维护教程与实训	计算机网络-职业教育-教材
嵌入式Linux驱动开发教程	Linux操作系统-程序设计-高等学校-教材
.NET Framework编程思想	程序设计
MyBatis从入门到精通	JAVA语言-程序设计
VC++深入详解	程序设计--C语言
Web渗透与漏洞挖掘	计算机网络-网络安全-研究
iPhone 4与iPad开发基础教程	便携式计算机-应用程序-程序设计
Delphi数据库开发基础与应用	软件工具-数据库系统-程序设计
网络文化概论	计算机网络-文化
C#语言程序设计基础实验指导.第2版	C语言-程序设计-高等学校-教学参考资料
玩转Python网络爬虫	软件工具-程序设计
HTML5与CSS3设计模式	超文本标记语言-程序设计
面向对象设计UML实践	面向对象语言-程序设计-教材
计算机网络管理教程	计算机网络管理-高等学校-教材
Visual C++网络编程开发与实战	C++语言-程序设计
Windows CE.Net程序设计	窗口软件-程序设计-教材
ASP.NET 2.0技术内幕	互联网络-程序设计
